0	0	0	0	0	0	0	0	0	0	0	0	0	0	0	0	0	0	0	0	0	0
0	0	0	0	0	0	0	0	0	0	0	0	0	0	0	0	0	0	0	0	0	0
0	0	0	0	0	0	0	29	17	16	17	17	17	30	0	0	0	0	0	0	0	0
0	0	0	0	0	0	0	27	0	8	0	0	0	26	0	0	0	0	0	0	0	0
0	0	0	0	0	0	0	27	0	8	0	0	0	26	0	0	0	0	0	0	0	0
0	0	0	0	0	0	0	27	0	154	5	6	0	26	0	0	0	0	0	0	0	0
0	0	0	0	0	0	0	27	0	0	0	0	0	26	0	156	0	0	0	0	0	0
0	0	0	0	0	0	0	31	28	316	28	28	28	32	0	0	0	0	0	0	0	0
0	0	0	0	0	0	0	0	0	0	0	0	0	0	0	0	0	0	0	0	0	0
0	0	0	0	0	0	0	0	0	0	0	0	0	0	0	0	0	0	0	0	0	0